gene_id	cell_type
ADCY1	vGLUT_enriched
ANO6	vGLUT_enriched
FADS1	vGLUT_enriched
FADS2	vGLUT_enriched
ITPR1	vGLUT_enriched
KCNJ6	vGLUT_enriched
KCNK10	vGLUT_enriched
KCNT2	vGLUT_enriched
MARCH2	vGLUT_enriched
NRSN1	vGLUT_enriched
NTRK3	vGLUT_enriched
PKD1	vGLUT_enriched
RYR2	vGLUT_enriched
RYR3	vGLUT_enriched
SFXN5	vGLUT_enriched
TMEM164	vGLUT_enriched
TRPC6	vGLUT_enriched
AAGAB	vGLUT_enriched
ABHD8	vGLUT_enriched
ACAA2	vGLUT_enriched
ACSBG1	vGLUT_enriched
ADD2	vGLUT_enriched
AGO2	vGLUT_enriched
AHCYL1	vGLUT_enriched
AHCYL2	vGLUT_enriched
AIFM3	vGLUT_enriched
AIP	vGLUT_enriched
AK2	vGLUT_enriched
AK4	vGLUT_enriched
AKT1	vGLUT_enriched
AKT2	vGLUT_enriched
AKT3	vGLUT_enriched
ALDH1L1	vGLUT_enriched
ALDH7A1	vGLUT_enriched
ALDOC	vGLUT_enriched
ALKBH5	vGLUT_enriched
ANAPC1	vGLUT_enriched
ANKIB1	vGLUT_enriched
ANKRA2	vGLUT_enriched
ANXA5	vGLUT_enriched
AP1S1	vGLUT_enriched
ARF3	vGLUT_enriched
ARHGAP10	vGLUT_enriched
ARHGEF19	vGLUT_enriched
ARRB1	vGLUT_enriched
ASB1	vGLUT_enriched
ASRGL1	vGLUT_enriched
ATAD2B	vGLUT_enriched
ATXN1	vGLUT_enriched
AXIN2	vGLUT_enriched
BAALC	vGLUT_enriched
BBS9	vGLUT_enriched
BCKDHB	vGLUT_enriched
BOK	vGLUT_enriched
BRPF3	vGLUT_enriched
BSN	vGLUT_enriched
BTAF1	vGLUT_enriched
BTBD17	vGLUT_enriched
CABLES1	vGLUT_enriched
CAMSAP1	vGLUT_enriched
CBFA2T2	vGLUT_enriched
CBL	vGLUT_enriched
CCAR2	vGLUT_enriched
CCDC117	vGLUT_enriched
CCDC148	vGLUT_enriched
CCDC85B	vGLUT_enriched
CCNI	vGLUT_enriched
CDC42EP4	vGLUT_enriched
CDC42SE2	vGLUT_enriched
CDK8	vGLUT_enriched
CDYL	vGLUT_enriched
CEP112	vGLUT_enriched
CLIC1	vGLUT_enriched
COX6A1	vGLUT_enriched
CPLX3	vGLUT_enriched
CPSF6	vGLUT_enriched
CREBL2	vGLUT_enriched
CREBRF	vGLUT_enriched
CRLF3	vGLUT_enriched
CRY2	vGLUT_enriched
CSRP1	vGLUT_enriched
CTBP1	vGLUT_enriched
CTNNA2	vGLUT_enriched
CTNNB1	vGLUT_enriched
CTNNBIP1	vGLUT_enriched
DCAF7	vGLUT_enriched
DEAF1	vGLUT_enriched
DENND1B	vGLUT_enriched
DGKI	vGLUT_enriched
DLGAP2	vGLUT_enriched
DNAH9	vGLUT_enriched
DNMBP	vGLUT_enriched
DNMT3A	vGLUT_enriched
DOHH	vGLUT_enriched
DPCD	vGLUT_enriched
DPYD	vGLUT_enriched
DRAP1	vGLUT_enriched
DTNBP1	vGLUT_enriched
DVL1	vGLUT_enriched
DYM	vGLUT_enriched
EEF1A1	vGLUT_enriched
EEF1B2	vGLUT_enriched
EEF1G	vGLUT_enriched
EEF2	vGLUT_enriched
EFHD2	vGLUT_enriched
EGLN2	vGLUT_enriched
EHMT1	vGLUT_enriched
EIF3B	vGLUT_enriched
EIF3H	vGLUT_enriched
EIF3K	vGLUT_enriched
EIF4E3	vGLUT_enriched
EIF5A	vGLUT_enriched
ELF2	vGLUT_enriched
EML2	vGLUT_enriched
EP400	vGLUT_enriched
ETV4	vGLUT_enriched
FAF1	vGLUT_enriched
FAM131B	vGLUT_enriched
FAM53B	vGLUT_enriched
FAM53C	vGLUT_enriched
FARS2	vGLUT_enriched
FASN	vGLUT_enriched
FAU	vGLUT_enriched
FBXO16	vGLUT_enriched
FBXW4	vGLUT_enriched
FLNA	vGLUT_enriched
FMN1	vGLUT_enriched
FOCAD	vGLUT_enriched
FRS2	vGLUT_enriched
GARNL3	vGLUT_enriched
GAS2	vGLUT_enriched
GCSH	vGLUT_enriched
GFAP	vGLUT_enriched
GIGYF2	vGLUT_enriched
GLIS3	vGLUT_enriched
GLUD1	vGLUT_enriched
GLUL	vGLUT_enriched
GNA13	vGLUT_enriched
GNL1	vGLUT_enriched
GPATCH2L	vGLUT_enriched
GPT2	vGLUT_enriched
GTF3C4	vGLUT_enriched
GUK1	vGLUT_enriched
H2AFJ	vGLUT_enriched
HERC2	vGLUT_enriched
HERC4	vGLUT_enriched
HES5	vGLUT_enriched
HIF1AN	vGLUT_enriched
HIPK3	vGLUT_enriched
HIRA	vGLUT_enriched
HIST1H1C	vGLUT_enriched
HIST1H2BJ	vGLUT_enriched
HPCAL4	vGLUT_enriched
HSD17B10	vGLUT_enriched
IDH2	vGLUT_enriched
INPP4A	vGLUT_enriched
INPP5B	vGLUT_enriched
IQGAP1	vGLUT_enriched
KALRN	vGLUT_enriched
KANSL1	vGLUT_enriched
KCTD3	vGLUT_enriched
KCTD5	vGLUT_enriched
KDM3A	vGLUT_enriched
KIF16B	vGLUT_enriched
KIF1A	vGLUT_enriched
KIF1B	vGLUT_enriched
KIF5C	vGLUT_enriched
KIFC3	vGLUT_enriched
KLC1	vGLUT_enriched
KRT18	vGLUT_enriched
KRT8	vGLUT_enriched
LMNA	vGLUT_enriched
LMNB2	vGLUT_enriched
LONP1	vGLUT_enriched
LRBA	vGLUT_enriched
LRCH3	vGLUT_enriched
LRRK2	vGLUT_enriched
LUC7L	vGLUT_enriched
MAGI2	vGLUT_enriched
MAP3K5	vGLUT_enriched
MAP3K9	vGLUT_enriched
MAPK4	vGLUT_enriched
KIAA0430	vGLUT_enriched
MATK	vGLUT_enriched
MBD3	vGLUT_enriched
MBTD1	vGLUT_enriched
MCF2L	vGLUT_enriched
MCM3AP	vGLUT_enriched
MED12	vGLUT_enriched
MED12L	vGLUT_enriched
METTL6	vGLUT_enriched
METTL9	vGLUT_enriched
MIB1	vGLUT_enriched
MLIP	vGLUT_enriched
MLLT10	vGLUT_enriched
MORN4	vGLUT_enriched
MTHFD2L	vGLUT_enriched
MYO1C	vGLUT_enriched
MYOF	vGLUT_enriched
MYRIP	vGLUT_enriched
NAB1	vGLUT_enriched
NAV3	vGLUT_enriched
NBAS	vGLUT_enriched
NCAPH2	vGLUT_enriched
NCS1	vGLUT_enriched
NDRG2	vGLUT_enriched
NDUFA8	vGLUT_enriched
NDUFB8	vGLUT_enriched
NDUFB9	vGLUT_enriched
NDUFV1	vGLUT_enriched
NEK9	vGLUT_enriched
NEURL4	vGLUT_enriched
NFATC3	vGLUT_enriched
NPLOC4	vGLUT_enriched
NRARP	vGLUT_enriched
NUDCD1	vGLUT_enriched
NUP160	vGLUT_enriched
OAZ1	vGLUT_enriched
PAN3	vGLUT_enriched
PAPSS1	vGLUT_enriched
PARP6	vGLUT_enriched
PDZD4	vGLUT_enriched
PEX5	vGLUT_enriched
PGM1	vGLUT_enriched
PHF21A	vGLUT_enriched
PHKA1	vGLUT_enriched
PHKB	vGLUT_enriched
PI4KA	vGLUT_enriched
PI4KB	vGLUT_enriched
PIK3C2A	vGLUT_enriched
PIK3C2B	vGLUT_enriched
PKIG	vGLUT_enriched
PLEC	vGLUT_enriched
PLEKHB2	vGLUT_enriched
PLEKHM2	vGLUT_enriched
PMS1	vGLUT_enriched
POLR3H	vGLUT_enriched
PPFIA1	vGLUT_enriched
PPFIA3	vGLUT_enriched
PPM1F	vGLUT_enriched
PPP1CA	vGLUT_enriched
PPP1R11	vGLUT_enriched
PPP1R16B	vGLUT_enriched
PPP1R1A	vGLUT_enriched
PPP1R3C	vGLUT_enriched
PPP2R2C	vGLUT_enriched
PPP3CC	vGLUT_enriched
PRDM5	vGLUT_enriched
PRDX6	vGLUT_enriched
PREX1	vGLUT_enriched
PTK2	vGLUT_enriched
PYGB	vGLUT_enriched
PYGM	vGLUT_enriched
QRICH1	vGLUT_enriched
R3HCC1L	vGLUT_enriched
R3HDM4	vGLUT_enriched
RAB11FIP4	vGLUT_enriched
RAB31	vGLUT_enriched
RABGEF1	vGLUT_enriched
RAD52	vGLUT_enriched
RALGAPA2	vGLUT_enriched
RAP1GAP2	vGLUT_enriched
RAPGEF4	vGLUT_enriched
RAVER2	vGLUT_enriched
RBFOX2	vGLUT_enriched
RBM4	vGLUT_enriched
REPS1	vGLUT_enriched
RERE	vGLUT_enriched
RIMS1	vGLUT_enriched
RIMS2	vGLUT_enriched
RIMS3	vGLUT_enriched
RND2	vGLUT_enriched
RNF10	vGLUT_enriched
RNF114	vGLUT_enriched
RNF220	vGLUT_enriched
RNF31	vGLUT_enriched
RPL10	vGLUT_enriched
RPL10A	vGLUT_enriched
RPL12	vGLUT_enriched
RPL13	vGLUT_enriched
RPL13A	vGLUT_enriched
RPL18	vGLUT_enriched
RPL18A	vGLUT_enriched
RPL19	vGLUT_enriched
RPL28	vGLUT_enriched
RPL3	vGLUT_enriched
RPL37	vGLUT_enriched
RPL37A	vGLUT_enriched
RPL38	vGLUT_enriched
RPL8	vGLUT_enriched
RPL9	vGLUT_enriched
RPLP0	vGLUT_enriched
RPLP2	vGLUT_enriched
RPRD1B	vGLUT_enriched
RPS10	vGLUT_enriched
RPS11	vGLUT_enriched
RPS14	vGLUT_enriched
RPS15	vGLUT_enriched
RPS16	vGLUT_enriched
RPS18	vGLUT_enriched
RPS19	vGLUT_enriched
RPS2	vGLUT_enriched
RPS20	vGLUT_enriched
RPS23	vGLUT_enriched
RPS27A	vGLUT_enriched
RPS28	vGLUT_enriched
RPS3	vGLUT_enriched
RPS5	vGLUT_enriched
RPS6KA4	vGLUT_enriched
RPS6KC1	vGLUT_enriched
RPS7	vGLUT_enriched
RPS8	vGLUT_enriched
RPSA	vGLUT_enriched
RTTN	vGLUT_enriched
S100A6	vGLUT_enriched
SARDH	vGLUT_enriched
SAT1	vGLUT_enriched
SBF1	vGLUT_enriched
SCMH1	vGLUT_enriched
SCRIB	vGLUT_enriched
SERGEF	vGLUT_enriched
SETBP1	vGLUT_enriched
SETD3	vGLUT_enriched
SFMBT2	vGLUT_enriched
SGSM2	vGLUT_enriched
SLC25A34	vGLUT_enriched
SLC9A3R1	vGLUT_enriched
SMAD1	vGLUT_enriched
SMG1	vGLUT_enriched
SMOX	vGLUT_enriched
SMYD4	vGLUT_enriched
SNF8	vGLUT_enriched
SNRK	vGLUT_enriched
SNX29	vGLUT_enriched
SNX8	vGLUT_enriched
SPTBN2	vGLUT_enriched
ST5	vGLUT_enriched
STAG1	vGLUT_enriched
STARD10	vGLUT_enriched
STAU2	vGLUT_enriched
STK3	vGLUT_enriched
STK35	vGLUT_enriched
STK39	vGLUT_enriched
SYMPK	vGLUT_enriched
TASP1	vGLUT_enriched
TBC1D9B	vGLUT_enriched
TBCD	vGLUT_enriched
TBCEL	vGLUT_enriched
TNS3	vGLUT_enriched
TOMM40L	vGLUT_enriched
TRAK2	vGLUT_enriched
TRIM35	vGLUT_enriched
TRRAP	vGLUT_enriched
TSC22D3	vGLUT_enriched
TST	vGLUT_enriched
TTC7B	vGLUT_enriched
TTLL5	vGLUT_enriched
TTN	vGLUT_enriched
TUB	vGLUT_enriched
UBE2M	vGLUT_enriched
UBE3B	vGLUT_enriched
UBN2	vGLUT_enriched
UBR4	vGLUT_enriched
UCK2	vGLUT_enriched
UEVLD	vGLUT_enriched
UIMC1	vGLUT_enriched
ULK4	vGLUT_enriched
UNC119B	vGLUT_enriched
UNC13B	vGLUT_enriched
UNC79	vGLUT_enriched
UNC80	vGLUT_enriched
VHL	vGLUT_enriched
VIM	vGLUT_enriched
VPS13D	vGLUT_enriched
VWA5B2	vGLUT_enriched
WDPCP	vGLUT_enriched
WDR13	vGLUT_enriched
WDR6	vGLUT_enriched
WHSC1	vGLUT_enriched
WSB2	vGLUT_enriched
WWC1	vGLUT_enriched
XPNPEP1	vGLUT_enriched
YEATS2	vGLUT_enriched
ZFAT	vGLUT_enriched
ZNF148	vGLUT_enriched
ZNF236	vGLUT_enriched
ZNF609	vGLUT_enriched
ZNF827	vGLUT_enriched
ZFX	vGLUT_enriched
ZNRF2	vGLUT_enriched
ARHGDIG	vGLUT_enriched
GLCCI1	vGLUT_enriched
GPX4	vGLUT_enriched
METRN	vGLUT_enriched
PDE2A	vGLUT_enriched
PLXNB1	vGLUT_enriched
RSPRY1	vGLUT_enriched
SDC4	vGLUT_enriched
BCL2L2	vGLUT_enriched
COX4I1	vGLUT_enriched
COX7A2L	vGLUT_enriched
COX8A	vGLUT_enriched
CTXN1	vGLUT_enriched
FAM163A	vGLUT_enriched
FIS1	vGLUT_enriched
FNDC3B	vGLUT_enriched
NDST3	vGLUT_enriched
OMA1	vGLUT_enriched
SERP2	vGLUT_enriched
SLC25A18	vGLUT_enriched
SMIM20	vGLUT_enriched
STX6	vGLUT_enriched
TMEM132D	vGLUT_enriched
USE1	vGLUT_enriched
C9orf3	vGLUT_enriched
C1orf198	vGLUT_enriched
KIAA0930	vGLUT_enriched
ABCA8	vGLUT_enriched
ADRBK1	vGLUT_enriched
ADRBK2	vGLUT_enriched
BZRAP1	vGLUT_enriched
FAM175A	vGLUT_enriched
FAM213B	vGLUT_enriched
GCN1L1	vGLUT_enriched
C4orf50	vGLUT_enriched
HECTD4	vGLUT_enriched
HMGXB3	vGLUT_enriched
HUWE1	vGLUT_enriched
SEPW1	vGLUT_enriched
TSSC1	vGLUT_enriched
UBE3D	vGLUT_enriched
ABCA5	vGLUT_depleted
ABHD16A	vGLUT_depleted
AGPAT1	vGLUT_depleted
AGPAT4	vGLUT_depleted
AIG1	vGLUT_depleted
ANO3	vGLUT_depleted
APLP2	vGLUT_depleted
ARL6IP1	vGLUT_depleted
ARL6IP5	vGLUT_depleted
ATL1	vGLUT_depleted
ATP1A1	vGLUT_depleted
ATP2B1	vGLUT_depleted
ATP6AP1	vGLUT_depleted
ATP6V0A1	vGLUT_depleted
ATP6V0B	vGLUT_depleted
ATP6V0C	vGLUT_depleted
ATP6V0E2	vGLUT_depleted
BCAP29	vGLUT_depleted
BCAP31	vGLUT_depleted
BSCL2	vGLUT_depleted
CACNG2	vGLUT_depleted
CACNG3	vGLUT_depleted
CASD1	vGLUT_depleted
CD47	vGLUT_depleted
CD9	vGLUT_depleted
CDIPT	vGLUT_depleted
CERS2	vGLUT_depleted
CHRM1	vGLUT_depleted
CHRM4	vGLUT_depleted
CLDN11	vGLUT_depleted
CLPTM1	vGLUT_depleted
CLPTM1L	vGLUT_depleted
CLSTN1	vGLUT_depleted
CNEP1R1	vGLUT_depleted
CNIH1	vGLUT_depleted
CX3CL1	vGLUT_depleted
DDOST	vGLUT_depleted
DEGS1	vGLUT_depleted
DPY19L3	vGLUT_depleted
ELOVL4	vGLUT_depleted
ELOVL6	vGLUT_depleted
EMC3	vGLUT_depleted
ENDOD1	vGLUT_depleted
ERGIC1	vGLUT_depleted
ERGIC3	vGLUT_depleted
FA2H	vGLUT_depleted
FAIM2	vGLUT_depleted
FAM171A2	vGLUT_depleted
G6PC3	vGLUT_depleted
GABRA1	vGLUT_depleted
GABRA2	vGLUT_depleted
GABRA3	vGLUT_depleted
GABRA4	vGLUT_depleted
GABRA5	vGLUT_depleted
GABRB2	vGLUT_depleted
GABRB3	vGLUT_depleted
GABRD	vGLUT_depleted
GABRG2	vGLUT_depleted
GDPD1	vGLUT_depleted
GJC3	vGLUT_depleted
GLRA2	vGLUT_depleted
GLRB	vGLUT_depleted
GPAA1	vGLUT_depleted
GPR137C	vGLUT_depleted
GPR155	vGLUT_depleted
GPR158	vGLUT_depleted
GPR22	vGLUT_depleted
GPR75	vGLUT_depleted
GPR88	vGLUT_depleted
GRIA2	vGLUT_depleted
GRIA3	vGLUT_depleted
GRIA4	vGLUT_depleted
GRIN1	vGLUT_depleted
GRINA	vGLUT_depleted
HCN1	vGLUT_depleted
HRH3	vGLUT_depleted
HTR2C	vGLUT_depleted
ITFG1	vGLUT_depleted
JKAMP	vGLUT_depleted
KCNC3	vGLUT_depleted
KCND2	vGLUT_depleted
KCNJ9	vGLUT_depleted
KCNK1	vGLUT_depleted
KCNQ5	vGLUT_depleted
KCNV1	vGLUT_depleted
KIT	vGLUT_depleted
KRTCAP2	vGLUT_depleted
LAPTM4A	vGLUT_depleted
LAPTM4B	vGLUT_depleted
LAPTM5	vGLUT_depleted
LEPROT	vGLUT_depleted
LEPROTL1	vGLUT_depleted
LHFPL4	vGLUT_depleted
LMBRD1	vGLUT_depleted
LMBRD2	vGLUT_depleted
KIAA1715	vGLUT_depleted
LRRC4	vGLUT_depleted
LRRC4C	vGLUT_depleted
LRRC8C	vGLUT_depleted
LRRTM4	vGLUT_depleted
MAL	vGLUT_depleted
MAL2	vGLUT_depleted
MAS1	vGLUT_depleted
MBOAT7	vGLUT_depleted
MBTPS2	vGLUT_depleted
MCHR1	vGLUT_depleted
MCOLN1	vGLUT_depleted
MFSD5	vGLUT_depleted
MIA3	vGLUT_depleted
MOG	vGLUT_depleted
MYADM	vGLUT_depleted
ND2	vGLUT_depleted
NDFIP1	vGLUT_depleted
NDFIP2	vGLUT_depleted
NPY1R	vGLUT_depleted
NPY2R	vGLUT_depleted
NRG3	vGLUT_depleted
NRSN2	vGLUT_depleted
OSTC	vGLUT_depleted
P2RY12	vGLUT_depleted
PAM	vGLUT_depleted
PGRMC1	vGLUT_depleted
PIGP	vGLUT_depleted
PIGT	vGLUT_depleted
PLLP	vGLUT_depleted
PLP1	vGLUT_depleted
PORCN	vGLUT_depleted
PRAF2	vGLUT_depleted
PRNP	vGLUT_depleted
PRRT2	vGLUT_depleted
RABAC1	vGLUT_depleted
REEP5	vGLUT_depleted
RNASEK	vGLUT_depleted
RNF103	vGLUT_depleted
RNF128	vGLUT_depleted
RNF170	vGLUT_depleted
RNF26	vGLUT_depleted
RTN1	vGLUT_depleted
RTN3	vGLUT_depleted
RTN4	vGLUT_depleted
RXFP1	vGLUT_depleted
SC5D	vGLUT_depleted
SCAMP1	vGLUT_depleted
SCAMP2	vGLUT_depleted
SCAMP5	vGLUT_depleted
SEC62	vGLUT_depleted
SERINC1	vGLUT_depleted
SERINC3	vGLUT_depleted
SHISA4	vGLUT_depleted
SLC17A6	vGLUT_depleted
SLC1A1	vGLUT_depleted
SLC22A17	vGLUT_depleted
SLC24A3	vGLUT_depleted
SLC2A13	vGLUT_depleted
SLC30A3	vGLUT_depleted
SLC32A1	vGLUT_depleted
SLC35A1	vGLUT_depleted
SLC35F1	vGLUT_depleted
SLC35G2	vGLUT_depleted
SLC38A7	vGLUT_depleted
SLC39A10	vGLUT_depleted
SLC39A6	vGLUT_depleted
SLC4A10	vGLUT_depleted
SLC6A15	vGLUT_depleted
SLC6A9	vGLUT_depleted
SLCO3A1	vGLUT_depleted
SPCS1	vGLUT_depleted
SQLE	vGLUT_depleted
SRD5A3	vGLUT_depleted
SSTR2	vGLUT_depleted
SYNGR3	vGLUT_depleted
SYNPR	vGLUT_depleted
SYP	vGLUT_depleted
SYVN1	vGLUT_depleted
TECR	vGLUT_depleted
TM2D2	vGLUT_depleted
TM9SF2	vGLUT_depleted
TMCO1	vGLUT_depleted
TMED10	vGLUT_depleted
TMED5	vGLUT_depleted
TMEFF2	vGLUT_depleted
TMEM121	vGLUT_depleted
TMEM127	vGLUT_depleted
TMEM128	vGLUT_depleted
TMEM130	vGLUT_depleted
TMEM131	vGLUT_depleted
TMEM147	vGLUT_depleted
TMEM158	vGLUT_depleted
TMEM163	vGLUT_depleted
TMEM165	vGLUT_depleted
TMEM175	vGLUT_depleted
TMEM179	vGLUT_depleted
TMEM184C	vGLUT_depleted
TMEM19	vGLUT_depleted
TMEM246	vGLUT_depleted
TMEM255A	vGLUT_depleted
TMEM259	vGLUT_depleted
TMEM30A	vGLUT_depleted
TMEM38A	vGLUT_depleted
TMEM50A	vGLUT_depleted
TMEM63B	vGLUT_depleted
TMEM63C	vGLUT_depleted
TMEM97	vGLUT_depleted
TMEM9B	vGLUT_depleted
TMUB2	vGLUT_depleted
TMX2	vGLUT_depleted
TRAM1L1	vGLUT_depleted
TRPC5	vGLUT_depleted
TSPAN13	vGLUT_depleted
TSPAN2	vGLUT_depleted
TSPAN3	vGLUT_depleted
TSPAN31	vGLUT_depleted
TSPAN5	vGLUT_depleted
TTYH2	vGLUT_depleted
TUSC3	vGLUT_depleted
UBXN8	vGLUT_depleted
UGCG	vGLUT_depleted
UNC50	vGLUT_depleted
WLS	vGLUT_depleted
YIF1B	vGLUT_depleted
YIPF4	vGLUT_depleted
ZDHHC17	vGLUT_depleted
ZDHHC8	vGLUT_depleted
ZDHHC9	vGLUT_depleted
ACSL4	vGLUT_depleted
ALG2	vGLUT_depleted
ANKRD26	vGLUT_depleted
ARID4B	vGLUT_depleted
ARL8B	vGLUT_depleted
ASIC2	vGLUT_depleted
ATAD1	vGLUT_depleted
ATP6V1D	vGLUT_depleted
ATP6V1E1	vGLUT_depleted
ATP6V1H	vGLUT_depleted
ATRX	vGLUT_depleted
BCAS1	vGLUT_depleted
BCLAF1	vGLUT_depleted
BEX1	vGLUT_depleted
CACNB4	vGLUT_depleted
CALB1	vGLUT_depleted
CAP2	vGLUT_depleted
CA10	vGLUT_depleted
CCDC88A	vGLUT_depleted
CCNH	vGLUT_depleted
CCPG1	vGLUT_depleted
CCSAP	vGLUT_depleted
CDH13	vGLUT_depleted
CELF4	vGLUT_depleted
CHM	vGLUT_depleted
CMIP	vGLUT_depleted
CTR9	vGLUT_depleted
CTSB	vGLUT_depleted
CTSS	vGLUT_depleted
CUL2	vGLUT_depleted
CUL4B	vGLUT_depleted
DDX3Y	vGLUT_depleted
DDX5	vGLUT_depleted
DHX36	vGLUT_depleted
DNAJA1	vGLUT_depleted
DNAJC8	vGLUT_depleted
DNM1L	vGLUT_depleted
DNTTIP2	vGLUT_depleted
DZIP3	vGLUT_depleted
EBAG9	vGLUT_depleted
EEA1	vGLUT_depleted
EGR1	vGLUT_depleted
EIF5B	vGLUT_depleted
ELAVL4	vGLUT_depleted
ELMOD1	vGLUT_depleted
EMC4	vGLUT_depleted
ERMN	vGLUT_depleted
F5	vGLUT_depleted
FAM19A1	vGLUT_depleted
FBXL2	vGLUT_depleted
FCHO2	vGLUT_depleted
FGF12	vGLUT_depleted
FSTL5	vGLUT_depleted
GAD2	vGLUT_depleted
GCC2	vGLUT_depleted
GDE1	vGLUT_depleted
GGNBP2	vGLUT_depleted
HERPUD1	vGLUT_depleted
HEXA	vGLUT_depleted
HIPK2	vGLUT_depleted
HSP90AA1	vGLUT_depleted
HSPA8	vGLUT_depleted
HSPH1	vGLUT_depleted
IDH3A	vGLUT_depleted
IER3IP1	vGLUT_depleted
IFT74	vGLUT_depleted
IGF2	vGLUT_depleted
IK	vGLUT_depleted
INPP5F	vGLUT_depleted
ITGA4	vGLUT_depleted
JAGN1	vGLUT_depleted
KCNAB1	vGLUT_depleted
KCNIP4	vGLUT_depleted
KCTD4	vGLUT_depleted
KIF3A	vGLUT_depleted
KIFAP3	vGLUT_depleted
LIN7A	vGLUT_depleted
LRCH2	vGLUT_depleted
MANEAL	vGLUT_depleted
MAP7D2	vGLUT_depleted
MATR3	vGLUT_depleted
MBNL2	vGLUT_depleted
MDH1	vGLUT_depleted
MEF2A	vGLUT_depleted
MEF2C	vGLUT_depleted
MESDC2	vGLUT_depleted
MICU3	vGLUT_depleted
MMP17	vGLUT_depleted
MOBP	vGLUT_depleted
MPHOSPH8	vGLUT_depleted
MPP5	vGLUT_depleted
NAE1	vGLUT_depleted
NAP1L1	vGLUT_depleted
NAP1L2	vGLUT_depleted
NAP1L3	vGLUT_depleted
NAP1L5	vGLUT_depleted
NDN	vGLUT_depleted
NECAB1	vGLUT_depleted
NEMF	vGLUT_depleted
NEUROD6	vGLUT_depleted
NFIA	vGLUT_depleted
NFIC	vGLUT_depleted
NKRF	vGLUT_depleted
NOVA1	vGLUT_depleted
NTM	vGLUT_depleted
OCIAD1	vGLUT_depleted
OGFRL1	vGLUT_depleted
OLA1	vGLUT_depleted
OLFM1	vGLUT_depleted
OLFM3	vGLUT_depleted
OLFML3	vGLUT_depleted
OXSR1	vGLUT_depleted
PAK1IP1	vGLUT_depleted
PALM2	vGLUT_depleted
PCM1	vGLUT_depleted
PCP4	vGLUT_depleted
PDE1A	vGLUT_depleted
PDS5B	vGLUT_depleted
PEX14	vGLUT_depleted
PHYHIPL	vGLUT_depleted
PLBD2	vGLUT_depleted
PLCB4	vGLUT_depleted
PLK2	vGLUT_depleted
PLS3	vGLUT_depleted
PPID	vGLUT_depleted
PPP1R12A	vGLUT_depleted
PPP2R2A	vGLUT_depleted
PPP3CA	vGLUT_depleted
PPP3R1	vGLUT_depleted
PRR18	vGLUT_depleted
PRUNE2	vGLUT_depleted
PSIP1	vGLUT_depleted
PSMA4	vGLUT_depleted
PTPRN2	vGLUT_depleted
RAB11FIP2	vGLUT_depleted
RAB3A	vGLUT_depleted
RAB6A	vGLUT_depleted
RAD23B	vGLUT_depleted
RASGRP1	vGLUT_depleted
RB1CC1	vGLUT_depleted
RBFOX1	vGLUT_depleted
RBM26	vGLUT_depleted
REEP2	vGLUT_depleted
RGS17	vGLUT_depleted
RGS2	vGLUT_depleted
RGS4	vGLUT_depleted
RGS7BP	vGLUT_depleted
RNF24	vGLUT_depleted
ROCK2	vGLUT_depleted
RTN4RL2	vGLUT_depleted
RUFY3	vGLUT_depleted
SCOC	vGLUT_depleted
SEPT7	vGLUT_depleted
SGIP1	vGLUT_depleted
SH3BGRL3	vGLUT_depleted
SHISA9	vGLUT_depleted
SLC25A14	vGLUT_depleted
SMAP1	vGLUT_depleted
SMARCA5	vGLUT_depleted
SMC1A	vGLUT_depleted
SMC3	vGLUT_depleted
SNAP25	vGLUT_depleted
SNX10	vGLUT_depleted
SNX14	vGLUT_depleted
SNX16	vGLUT_depleted
SRR	vGLUT_depleted
SSB	vGLUT_depleted
ST3GAL5	vGLUT_depleted
ST8SIA4	vGLUT_depleted
STIM2	vGLUT_depleted
STIP1	vGLUT_depleted
STMN2	vGLUT_depleted
STMN3	vGLUT_depleted
STMN4	vGLUT_depleted
TAX1BP1	vGLUT_depleted
THY1	vGLUT_depleted
TMEM151A	vGLUT_depleted
TMEM189	vGLUT_depleted
TMF1	vGLUT_depleted
TOP1	vGLUT_depleted
TPR	vGLUT_depleted
TRIP11	vGLUT_depleted
TSG101	vGLUT_depleted
TXNDC16	vGLUT_depleted
UBC	vGLUT_depleted
UBLCP1	vGLUT_depleted
UBQLN2	vGLUT_depleted
UBXN4	vGLUT_depleted
UCHL1	vGLUT_depleted
USP14	vGLUT_depleted
VSNL1	vGLUT_depleted
WASF1	vGLUT_depleted
YTHDC1	vGLUT_depleted
YWHAB	vGLUT_depleted
YWHAH	vGLUT_depleted
YWHAZ	vGLUT_depleted
ZEB2	vGLUT_depleted
ZNF260	vGLUT_depleted
ZSCAN26	vGLUT_depleted
ACHE	vGLUT_depleted
ADAM23	vGLUT_depleted
ADCYAP1	vGLUT_depleted
AEBP1	vGLUT_depleted
APOD	vGLUT_depleted
ARSA	vGLUT_depleted
ARSB	vGLUT_depleted
BRINP1	vGLUT_depleted
C1QA	vGLUT_depleted
C1QB	vGLUT_depleted
C1QTNF4	vGLUT_depleted
CACNA2D1	vGLUT_depleted
CACNA2D3	vGLUT_depleted
CALR	vGLUT_depleted
CBLN2	vGLUT_depleted
CCDC47	vGLUT_depleted
CFH	vGLUT_depleted
CHGA	vGLUT_depleted
CHGB	vGLUT_depleted
CNPY2	vGLUT_depleted
CNTN1	vGLUT_depleted
CNTN4	vGLUT_depleted
CNTN6	vGLUT_depleted
COCH	vGLUT_depleted
CPM	vGLUT_depleted
CREG2	vGLUT_depleted
CRHBP	vGLUT_depleted
CRTAC1	vGLUT_depleted
CTSA	vGLUT_depleted
CTSV	vGLUT_depleted
CYP46A1	vGLUT_depleted
DCN	vGLUT_depleted
DKK3	vGLUT_depleted
EDIL3	vGLUT_depleted
ENPP6	vGLUT_depleted
EPDR1	vGLUT_depleted
ERLEC1	vGLUT_depleted
ERP44	vGLUT_depleted
FAM134A	vGLUT_depleted
FMOD	vGLUT_depleted
GRN	vGLUT_depleted
HS3ST1	vGLUT_depleted
HSP90B1	vGLUT_depleted
HSPA5	vGLUT_depleted
IGFBP4	vGLUT_depleted
IL34	vGLUT_depleted
LGI1	vGLUT_depleted
LGI3	vGLUT_depleted
LGMN	vGLUT_depleted
LPL	vGLUT_depleted
LRPAP1	vGLUT_depleted
LY6H	vGLUT_depleted
MANF	vGLUT_depleted
MCFD2	vGLUT_depleted
MINPP1	vGLUT_depleted
NCAM1	vGLUT_depleted
NEGR1	vGLUT_depleted
NELL2	vGLUT_depleted
NETO1	vGLUT_depleted
NOV	vGLUT_depleted
NPTX2	vGLUT_depleted
NRN1	vGLUT_depleted
NUCB1	vGLUT_depleted
NUCB2	vGLUT_depleted
NXPH3	vGLUT_depleted
OLFM2	vGLUT_depleted
PCSK1	vGLUT_depleted
PCSK2	vGLUT_depleted
PCYOX1	vGLUT_depleted
PDIA3	vGLUT_depleted
PENK	vGLUT_depleted
PIGK	vGLUT_depleted
PLAT	vGLUT_depleted
PPT1	vGLUT_depleted
PRKCSH	vGLUT_depleted
PSAP	vGLUT_depleted
PTGDS	vGLUT_depleted
PTGS2	vGLUT_depleted
RESP18	vGLUT_depleted
RGMB	vGLUT_depleted
RTN4R	vGLUT_depleted
SCG5	vGLUT_depleted
SEMA3A	vGLUT_depleted
SEMA3C	vGLUT_depleted
SEMA3E	vGLUT_depleted
SERPINI1	vGLUT_depleted
SPARCL1	vGLUT_depleted
SPOCK1	vGLUT_depleted
SPOCK2	vGLUT_depleted
SST	vGLUT_depleted
SULF1	vGLUT_depleted
TAC1	vGLUT_depleted
TIMP2	vGLUT_depleted
TTC13	vGLUT_depleted
TTR	vGLUT_depleted
TXNDC12	vGLUT_depleted
VCAN	vGLUT_depleted
VGF	vGLUT_depleted
VIP	vGLUT_depleted
VSTM2A	vGLUT_depleted
VSTM2L	vGLUT_depleted
VTN	vGLUT_depleted
ALCAM	vGLUT_depleted
APP	vGLUT_depleted
ATP6AP2	vGLUT_depleted
B2M	vGLUT_depleted
B4GALNT1	vGLUT_depleted
BSG	vGLUT_depleted
CADM2	vGLUT_depleted
CADM3	vGLUT_depleted
CANX	vGLUT_depleted
CCK	vGLUT_depleted
CD164	vGLUT_depleted
CD34	vGLUT_depleted
CDH10	vGLUT_depleted
CDH11	vGLUT_depleted
CDH2	vGLUT_depleted
CDH7	vGLUT_depleted
CHST1	vGLUT_depleted
CNTNAP2	vGLUT_depleted
CTSD	vGLUT_depleted
DLK1	vGLUT_depleted
DNAJB11	vGLUT_depleted
DNAJB9	vGLUT_depleted
DNER	vGLUT_depleted
ELFN1	vGLUT_depleted
EMB	vGLUT_depleted
EMC10	vGLUT_depleted
ENPP4	vGLUT_depleted
ENPP5	vGLUT_depleted
EPHA4	vGLUT_depleted
EPHA7	vGLUT_depleted
ERP29	vGLUT_depleted
FAM171B	vGLUT_depleted
FAM174B	vGLUT_depleted
FLRT2	vGLUT_depleted
FLRT3	vGLUT_depleted
GLG1	vGLUT_depleted
HEXB	vGLUT_depleted
HS6ST2	vGLUT_depleted
HSPA13	vGLUT_depleted
IFNGR2	vGLUT_depleted
IGSF8	vGLUT_depleted
ISLR2	vGLUT_depleted
JAM3	vGLUT_depleted
L1CAM	vGLUT_depleted
LAMP1	vGLUT_depleted
LAMP2	vGLUT_depleted
LAMP5	vGLUT_depleted
LINGO1	vGLUT_depleted
LRRC24	vGLUT_depleted
LRRC4B	vGLUT_depleted
LRRN1	vGLUT_depleted
LRRN2	vGLUT_depleted
LRRN3	vGLUT_depleted
LRRTM2	vGLUT_depleted
LRRTM3	vGLUT_depleted
LY6E	vGLUT_depleted
M6PR	vGLUT_depleted
MAG	vGLUT_depleted
MANSC1	vGLUT_depleted
MEGF11	vGLUT_depleted
NCAM2	vGLUT_depleted
NETO2	vGLUT_depleted
NPDC1	vGLUT_depleted
NPY	vGLUT_depleted
NRCAM	vGLUT_depleted
OMG	vGLUT_depleted
OS9	vGLUT_depleted
OSTM1	vGLUT_depleted
PARM1	vGLUT_depleted
PCDHGA5	vGLUT_depleted
PDIA6	vGLUT_depleted
PIANP	vGLUT_depleted
PTPRO	vGLUT_depleted
RNASE4	vGLUT_depleted
RPN1	vGLUT_depleted
SCG2	vGLUT_depleted
SCN1B	vGLUT_depleted
SDF2	vGLUT_depleted
SEZ6L2	vGLUT_depleted
SIRPA	vGLUT_depleted
SLITRK1	vGLUT_depleted
SLITRK2	vGLUT_depleted
SLITRK4	vGLUT_depleted
SLITRK5	vGLUT_depleted
SPOCK3	vGLUT_depleted
SSR2	vGLUT_depleted
SSR4	vGLUT_depleted
SULF2	vGLUT_depleted
TMED4	vGLUT_depleted
TMEM132A	vGLUT_depleted
TMEM59	vGLUT_depleted
TMEM59L	vGLUT_depleted
TMEM9	vGLUT_depleted
TMX3	vGLUT_depleted
TXNDC15	vGLUT_depleted
VSTM2B	vGLUT_depleted
ABHD12	vGLUT_depleted
ABHD6	vGLUT_depleted
ACP2	vGLUT_depleted
ACSL3	vGLUT_depleted
ACSL5	vGLUT_depleted
ALG11	vGLUT_depleted
APLP1	vGLUT_depleted
ARL10	vGLUT_depleted
ATP1B1	vGLUT_depleted
B3GALNT1	vGLUT_depleted
B3GALT1	vGLUT_depleted
B3GALT2	vGLUT_depleted
B4GALT3	vGLUT_depleted
B4GALT6	vGLUT_depleted
BDNF	vGLUT_depleted
C1GALT1C1	vGLUT_depleted
CADM1	vGLUT_depleted
CALY	vGLUT_depleted
CASC4	vGLUT_depleted
CD200	vGLUT_depleted
CDH6	vGLUT_depleted
CDH8	vGLUT_depleted
CGRRF1	vGLUT_depleted
CHL1	vGLUT_depleted
CHST12	vGLUT_depleted
CISD1	vGLUT_depleted
CISD2	vGLUT_depleted
COMT	vGLUT_depleted
DGAT2	vGLUT_depleted
DNAJC10	vGLUT_depleted
DPP10	vGLUT_depleted
DPP6	vGLUT_depleted
EFNB3	vGLUT_depleted
EMC7	vGLUT_depleted
ENPP2	vGLUT_depleted
ERLIN1	vGLUT_depleted
EXTL2	vGLUT_depleted
FUT9	vGLUT_depleted
GAA	vGLUT_depleted
GAL3ST3	vGLUT_depleted
GALNT13	vGLUT_depleted
GGT7	vGLUT_depleted
GLT8D1	vGLUT_depleted
HSD17B12	vGLUT_depleted
HSPA4L	vGLUT_depleted
ITM2A	vGLUT_depleted
ITM2B	vGLUT_depleted
ITM2C	vGLUT_depleted
LPCAT4	vGLUT_depleted
LRP11	vGLUT_depleted
MANEA	vGLUT_depleted
MTDH	vGLUT_depleted
NAT14	vGLUT_depleted
NCEH1	vGLUT_depleted
NCSTN	vGLUT_depleted
NDUFA4	vGLUT_depleted
NSG1	vGLUT_depleted
HMP19	vGLUT_depleted
PLD3	vGLUT_depleted
PMEPA1	vGLUT_depleted
PODXL2	vGLUT_depleted
PTN	vGLUT_depleted
PTPRN	vGLUT_depleted
QPCT	vGLUT_depleted
QPCTL	vGLUT_depleted
RDH14	vGLUT_depleted
RNF13	vGLUT_depleted
ROBO2	vGLUT_depleted
SCCPDH	vGLUT_depleted
SDC2	vGLUT_depleted
SEC11C	vGLUT_depleted
SEZ6	vGLUT_depleted
SGCB	vGLUT_depleted
SGCE	vGLUT_depleted
SHISA5	vGLUT_depleted
SMIM19	vGLUT_depleted
SMPD1	vGLUT_depleted
ST8SIA3	vGLUT_depleted
SYT1	vGLUT_depleted
SYT11	vGLUT_depleted
SYT3	vGLUT_depleted
SYT4	vGLUT_depleted
SYT5	vGLUT_depleted
TEX264	vGLUT_depleted
THEM6	vGLUT_depleted
TM2D3	vGLUT_depleted
TMEM106B	vGLUT_depleted
TMEM108	vGLUT_depleted
TMEM68	vGLUT_depleted
VOPP1	vGLUT_depleted
WBSCR17	vGLUT_depleted
YIPF5	vGLUT_depleted
YME1L1	vGLUT_depleted
C14orf1	vGLUT_depleted
C3orf58	vGLUT_depleted
C14orf37	vGLUT_depleted
C5orf15	vGLUT_depleted
KIAA1107	vGLUT_depleted
C11orf87	vGLUT_depleted
C1orf27	vGLUT_depleted
C6orf89	vGLUT_depleted
C16orf52	vGLUT_depleted
CTAGE5	vGLUT_depleted
CTGF	vGLUT_depleted
ERO1L	vGLUT_depleted
FAM105A	vGLUT_depleted
FAM134B	vGLUT_depleted
FAM69A	vGLUT_depleted
HGSNAT	vGLUT_depleted
KITLG	vGLUT_depleted
LHFPL3	vGLUT_depleted
LRRTM1	vGLUT_depleted
NT5C3A	vGLUT_depleted
PRRC2C	vGLUT_depleted
SCN2A	vGLUT_depleted
SEP15	vGLUT_depleted
TMEM35	vGLUT_depleted
TMEM57	vGLUT_depleted
TOMM70A	vGLUT_depleted
TF	vGLUT_depleted
TP53I11	vGLUT_depleted
UGT8	vGLUT_depleted
VIMP	vGLUT_depleted
WBP5	vGLUT_depleted
ZNF729	vGLUT_depleted
